WE wall_texture/fire.png
NO wall_texture/water.png
SO wall_texture/earth.png
EA wall_texture/air.png
C 4294967500  ,0,73
F 15,6,5

11111111111111111111      
111111000111111 1   1    
111110000011111 1   1   
1111000N0000001 11111
111000000000111  
110000000000011
100001111100001
110000111000011
111000010000111
111100000001111
111110000011111
111111000111111
111111111111111