

NO = ./texture_no.xpm
SO = ./texture_so.xpm
WE = ./texture_we.xpm
EA = ./texture_ea.xpm


F = 0,0,200
C = 0,0,200


11111111111111111111111111
10001111111111111111111111
10101111111111111111111111
10001111111111111111111111
10N01111111111111111111111
11111111111111111111111111
