

NO = ./texture_no.xpm
SO = ./texture_so.xpm
WE = ./texture_we.xpm
EA = ./texture_ea.xpm


F = 200,150,255
C = 200,200,200


11111111111111111111111111
10001111111111111111111111
10101111111111111111111111
10001111111111111111111111
10N01111111111111111111111
11111111111111111111111111