NO  wall_texture/fire.png
SO  wall_texture/air.png
WE wall_texture/water.png
EA wall_texture/earth.png
F 220,100,0
C 225,30,0

1111111111111111111111111
1000000000110000000000001
1011000001110000000000001
10010000000000000000000011111111
111111111D11000001110000000000001
1000000000110000011101111D1111111
11110111111111011100N00010001
1111D111111111011101010010001
11000000110101011100000010001
10000000000000001100000010001
10000000000000001101010010001
1100000111010101111101111000111
11110111 1110101 101111010001
11111111 11111111111111111111