NO  wall_texture/fire.png
SO  wall_texture/air.png
WE wall_texture/water.png
EA wall_texture/earth.png
F 250,150,60
C 0,0,0

11111111111111111
1000000000001
1000001110001
1000000000101
1000110N000011
100000000000101    
11111111111111