NO  wall_texture/fire.png
SO  wall_texture/air.png

WE wall_texture/water.png
EA wall_texture/earth.png

F 250,150,60
C 0,0,0

11111111111111111111111111
10000000001100000000000011
101100000111000000000000101
10010000000000000000000011111111
111111111011000001110000000000001
100000000011000001110111101111111
11110111111111011100N000101
111101111111110111010100101
111101111111110111010100101
110000001101010111000000101
100000000000000011000000101
1000000000000000110101001011
100000000000000011000000101
1000000000000000110101001011
100000000000000011000000101
1000000000000000110101001011
100000000000000011000000101
1000000000000000110101001011
100000000000000011000000101
1000000000000000110101001011
100000000000000011000000101
1000000000000000110101001011
100000000000000011000000101
1000000000000000110101001011
1100000111010101111101111010111
11110111 1110101 101111010101
11110111 1110101 101111010101
11111111 11111111111111111111