NO  wall_texture/fire.png
SO  wall_texture/air.png
WE wall_texture/water.png
EA wall_texture/earth.png
F 60,60,60
C 150,150,150

11111111111111111
10000000000000101
11000000000000101
11000000000000101
10000000000000101
11000000000000101
11000000000000101
100000000N0000101
11000000000000101
11000000000000001
10000000000000001
11000000000000001
11000000000000001
10000000000000001
11000000000000001
11000000000000001
10000000000000001
11000000000000001
11000000000000001
10000000000000001
11000000000000001
11000000000000001
10000000000000001
11000000000000001
11000000000000001
10000000000000101
11000000000000101
11000000000000101
10000000000000101
11000000000000101
11000000000000101
10000000000000101
11000000000000101
11000000000000101
10000000000000101
11000000000000101
10000000000000101
11000000000000101
11000000000000101
10000000000000101
11000000000000101
11000000000000101
10000000000000101
11000000000000101
11000000000000001
10000000000000001
11000000000000001
11000000000000001
10000000000000001
11000000000000001
11000000000000001
10000000000000001
11000000000000001
11000000000000001
10000000000000001
11000000000000001
11000000000000001
10000000000000001
11000000000000001
11000000000000001
10000000000000101
11000000000000101
11000000000000101
10000000000000101
11000000000000101
11000000000000101
10000000000000101
11000000000000101
11000000000000101
10000000000000101
11000000000000101
10000000000000101
11000000000000101
11000000000000101
10000000000000101
11000000000000101
11000000000000101
10000000000000101
11000000000000101
11000000000000001
10000000000000001
11000000000000001
11000000000000001
10000000000000001
11000000000000001
11000000000000001
10000000000000001
11000000000000001
11000000000000001
10000000000000001
11000000000000001
11000000000000001
10000000000000001
11000000000000001
11000000000000001
10000000000000101
11000000000000101
11000000000000101
10000000000000101
11000000000000101
11000000000000101
10000000000000101
11000000000000101
11000000000000101
10000000000000101
11000000000000101
11111111111111111