NO  wall_texture/fire.png
SO  wall_texture/air.png
WE wall_texture/water.png
EA wall_texture/earth.png
F 220,100,0
C 225,30,0

11111111111111111111111111
10000000001100000000000011
101100000111000000000000101
10010000000000000000000011111111
111111111D11000001110000000000001
1000000000110000011101111D1111111
11110111111111011100N000101
1111D11111111101110101001D1
1111D1111111110111010100101
1100000011010101110000001D1
100000000000000011000000101
1000000000000000110101001D11
100000000000000011000000101
1000000000000000110101001D11
100000000000000011000000101
1000000000000000110101001D11
100000000000000011000000101
1000000000000000110101001D11
100000000000000011000000101
1000000000000000110101001D11
100000000000000011000000101
1000000000000000110101001D11
100000000000000011000000101
1000000000000000110101001D11
1100000111010101111101111010111
11110111 1110101 10111101D101
11110111 1110101 101111010101
11111111 11111111111111111111
