NO = ./texture_no.xpm
SO = ./texture_so.xpm
WE = ./texture_we.xpm
EA = ./texture_ea.xpm


F = 200,150,255
C = 200,200,200

11111111111111111111111111111111
100000000000000000000000000011
111100000000000000000000000000001
110010100001001010100000000000001
110000001000000000000000000000001
11000100000N000000000000111100001
110000001000000000001111111000001
110000000000000000000000010001
1100000001110000000000000000001
11111111111111111111111111111111
