NO = ./texture_no.xpm
SO = ./texture_so.xpm
WE = ./texture_we.xpm
EA = ./texture_ea.xpm


F = 0,0,0
C = 100, 0, 0

1111111111111111111111111111111111
1000000000000000000010001000000001
1111000000000001000000100010000001
110000000000000001010010001000001
1100000010000000000000000001000001
110001000000000000000000N00000001
1100000010000000000000000000000001
110000000000000000000000010001
1100000000000000000000000000001
1100000000000000000000000000001
11000000000000000000000000000001
11111111111111111111111111111111
