NO = ./texture_no.xpm
SO = ./texture_so.xpm
WE = ./texture_we.xpm
EA = ./texture_ea.xpm


F = 200,150,255
C = 200,200,200

11111111111111111111111111111111
11110000001011111111111111111111
111100000000000001
1111011111111110001100000000000001
111100010000000000001
1111100000N00001111111100001
11110001000000000001111111000001
111100111111110001
1111000011111111111000000000001
11111111111111111111111111111111
