NO = ./texture_no.xpm
SO = ./texture_so.xpm
WE = ./texture_we.xpm
EA = ./texture_ea.xpm


F = 200,150,255
C = 200,200,200

1111111111111111111111111111111111111111111111111111
1000000000000000000000000000000000000000000000000001
1111000000000000000000000000000000000000000000000001
110000000000000000000000000000000000000000000000001
1100000010000000000000000000000000000000000000000001
110001000000000000000000N00000000000000000000000001
1100000010000000000000000000000000000000000000000001
110000000000000000000000010001
1100000000000000000000000000001
1100000000000000000000000000001
11000000000000000000000000000001
11111111111111111111111111111111
