NO = ./test.png
SO = ./texture_so.xpm
WE = ./texture_we.xpm
EA = ./texture_ea.xpm

F = 200 ,200, 200
C = 120, 6, 6

1111111111111111111111111111111111
1000000000000000000010001000000001
1111000000000001000000100010000001
110000000000000001D10010001000001
1100000010000000000000001001000001
110001000000000000N00000D0000001
1100000010000000000000001000000001
110000000000000000000000010001
1100000000000000000000000000001
1100000000000000000000000000001
11000000000000000000000000000001
11111111111111111111111111111111
