NO ./test.png
SO ./texture_so.xpm
WE ./texture_we.xpm
EA ./texture_ea.xpm

F = 92, 64, 51
C = 20, 20, 20

1111111111111111111111111111111111
1000000000000000000010001000000001
11110000000000010000001000100000011
110000000000000001010010001000001
11000000100000000000000010010000011101
110001000000000000N00001D10000011
1100000010000000000000001000000001
110000000000000000000000010001111
110000000000000000000000000000101
11000000000000000000000000000011
11000000000000000000000000000001
11111111111111111111111111111111
