NO = ./texture_no.xpm
SO = ./texture_so.xpm
WE = ./texture_we.xpm
EA = ./texture_ea.xpm


F = 200,150,255
C = 200,200,200

11111111111111111111111111111
10000001000000000000000000001
100000000000001
1000000000N001100000000000001
10001000000000000000000000001
10001000000000000000000000001
10001000000000001111111000001
100000000000001
10000000000000000000000000001
11111111111111111111111111111
