F 139,99,58
C 171,154,137

NO textures/simonkraft/bookshelf.xpm
SO textures/simonkraft/bookshelf_01.xpm
WE textures/simonkraft/bookshelf_02.xpm
EA textures/simonkraft/bookshelf_03.xpm

1111111111111111111
1001001001001001001
10010D1001001001001
1001001001001001001
1001001000001001001
10000000S000100001111
100A00011111111000001
11100000000000011111
1000000101010000001
1111111111111111111
