WE wall_texture/fire.png
NO wall_texture/water.png
SO wall_texture/earth.png

F   69, 222, 199

EA wall_texture/air.png



C 235, 198, 52

111111111111111111111111
100000000000000000000001
10000001D100000000000001
100000000000001000000001
10000000000N00D000000001
100000100000001000000001
100000D00000000000000001
10000011D110000101010001
100000000000000000000001
1000A0000010000100010001
100000000010000000000001
100000111100001010100001
100000000000000000000001
100000000000000000000001
100000000000000000000001
100000000000000000000001
100000000000000000000001
100000000000000000000001
100000000000000000000001
111111111000000000000001
100100001000000000000001
100000101000000000000001
100100001000000000000001
100111111000000000000001
100000000000000000000001
100000000000000000000001
111111111111111111111111
