WE wall_texture/fire.png
NO wall_texture/water.png
SO wall_texture/earth.png

F   59, 100, 89

EA wall_texture/air.png



C 150, 150, 150

111111111111111111111111
100000000000000000000001
10000001D100000000000001
100000000000001000000001
10000000000S00D000000001
100000100000001000000001
100111111000000000000001
100000000000000000000001
100000000000000000000001
111111111111111111111111
