WE wall_texture/fire.png
NO wall_texture/water.png
SO wall_texture/earth.png
EA wall_texture/air.png

F   59, 100, 89




C 150, 150, 150

11111111111111111111111
100000000000000000000001
10000001D11000000000001
100000000000001000000001
10000000000S00D000000001
100000100000001000000001
100111111000000000000001
100000000000000000000001
100000000000000000000001
111111111111111111111111
