
WE wall_texture/fire.png
NO wall_texture/water.png
SO wall_texture/earth.png
EA wall_texture/air.png
F 20,20,20
C 200,200,200

111111
100011
100011
100011
100011
100011
110S011
100011
100011
100011
100011
100011
111111       
