WE wall_texture/fire.png
NO wall_texture/water.png
SO wall_texture/earth.png
EA wall_texture/air.png

F 255,20,20
C 200,200,200

111111111111111111111111111111
1S0000000000000000000000000001
111111111111111111111111111111