NO textures/test/north.xpm
SO textures/test/south.xpm
WE textures/test/west.xpm
EA textures/test/

F 20,20,20
C 200,200,200

1111111111
1000000011
10S0000011
1000000011
101D100001
1000000011
1100000011
1000000011
1000000011
1000000011
1000000011
1000000011
1111111111
