F 100,100,100
C 60, 60,60

WE wall_texture/fire.png
NO wall_texture/water.png
SO wall_texture/earth.png
EA wall_texture/air.png

1111111111111111111
10W1001001001000001
1011000001000001001
1001001001D11101111
1001111000001001001
1000000000000001001
1001111111111001001
1111000000000001011
1000000001000000001
1111111111111111111
