F 163, 100, 62
C 146, 161, 207

WE wall_texture/fire.png
NO wall_texture/water.png
SO wall_texture/earth.png
EA wall_texture/air.png

1111111111111111111
1001001001001001001
1001001001001001001
1001001001001001001
1001001000001001001
10000000S000100001111
100000011D11111000001
11100000000000011111
1000000101010000001
1111111111111111111
